T1111111111111111111111111111111
1......................m.......1
1.........1...1...1............1
1.........1...1................1
1.........11111...1.p..........1
1.........1...1...1........s...1
1.........1...1...1............1
1..............................1
11111111111111111111111.....1111
1.....................11...11..1
1......................1..11...1
1..........c..........11..11...1
1...................111..11....1
1..................11...11.....1
1................111..111......1
1............11111...11........1
1...........11.....111.........1
1..........11..11111...........1
1...........1.11...............1
1..........11.11...............1
1.........111.111..............1
1........1111.1111.............1
1.......11111N11111............1
11111111111.....1111111111111111